1T111c11111
10000000001
10000000001
1000000000b
t0000000001
m000000000b
o0000000001
1000000000b
10000000001
10000000001
111s1s1s111